XXXXXXXX
XX XXX X
X      X
XX XXX X
X  XXX X
XH XXX X
X      X
XXXXXXXX